0,0,0,0,0,0,0,0,0,0,0,0,0,0,0,0
0,0,0,0,0,2,0,0,2,1,1,2,0,0,0,0
0,0,0,0,0,1,0,0,1,0,0,1,0,0,2,2
0,0,0,0,0,1,0,0,1,0,0,1,0,0,1,0
0,0,0,0,0,2,1,1,2,0,0,2,1,1,2,0
0,0,0,0,0,1,0,0,1,0,0,1,0,0,1,0
0,0,0,0,0,1,0,0,1,0,0,1,0,0,2,2
0,0,0,0,0,2,0,0,2,1,1,2,0,0,0,0
0,0,0,0,0,0,0,0,0,0,0,0,0,0,0,0
routes
15,6,LDLULDLU
15,2,LULDLULD
1,6,L